5 10
|--------|
|.f.|..-.|
|..-|.@..|
|.f....-.|
|--------|