5 10
|--------|
|.f.|..-.|
|..-|.@p.|
|.f....-.|
|--------|